=========..=========
=..................=
=  .     ==    ..=.=
=  .=f=.====...=f=.=
=  .....ffff.=...=.=
==================.=
===*............*=.=
===................=
=.......=..       .=
== = =  =  =  =  =.=
.. fffffffffffffff..
=========.==.=======
= . g..=.....=g....=
= | =..=.===.=.....=
= | =...... .......=
= | =..=.===.=...=.=
= | =*.=.= =.=..*=.=
= | ===.====.=====.=
= | ...............=
=========..=========
