=========..=========
=..*...............=
=...            .=.=
=...=...====...=.=.=
===...=......=...=.=
==================.=
===*............*=.=
=..................=
=.......==.=.......=
=..==...=..=.......=
........=.==........
=.=====.=..=.=====.=
=.=g..=......=g..=.=
=.=...=.====.=...=.=
=.=..............=.=
=.=...=.====.=...=.=
=.=*..=.=  =.=..*=.=
=.=====.====.=====.=
=..................=
=========..=========
