=========..=========
=..*...............=
===.            .=.=
===.=...====...=.=.=
===...=......=...=.=
==================.=
===*............*=.=
=..................=
=.......==.=.......=
=..==...=..=.......=
........=.==........
=.=====.=..=.=====.=
=.=g..=......=g..=.=
=.=...=.====.=...=.=
=.=..............=.=
=.=...=.====.=...=.=
=.=*..=.=  =.=..*=.=
=.=====.====.=====.=
=..................=
=========..=========
