=========..=========
=..................=
=  .     ==    ..=.=
=  .=.=.====...===.=
=  ..........=...=.=
==================.=
===*............*=.=
=========.========.=
=.......=..=.......=
=.=====.==.=.=====.=
........=..=........
=========.==.=======
= . g..=.....=g....=
= | =..=.===.=.....=
= | =...... .......=
= | =..=.===.=...=.=
= | =*.=.= =.=..*=.=
= | ===.====.=====.=
= | ...............=
=========..=========
